# Sorted by Phase, Instrument, Processing-Level
/holdings/ro-x-osinac-2-cvp1-checkout-v1.0/	Rosetta-Orbiter OSIRIS Narrow Angle Camera Commissioning 1 & C/2002 T7 (LINEAR) Raw Data	RO-X-OSINAC-2-CVP1-CHECKOUT-V1.0
/holdings/ro-x-osinac-3-cvp1-checkout-v1.0/	Rosetta-Orbiter OSIRIS Narrow Angle Camera Commissioning 1 & C/2002 T7 (LINEAR) Calibrated Data	RO-X-OSINAC-3-CVP1-CHECKOUT-V1.0
/holdings/ro-x-osinac-4-cvp1-checkout-v1.0/	Rosetta-Orbiter OSIRIS Narrow Angle Camera Commission 1 & C/2002 T7 (LINEAR) Resampled-A (Geometric Distortion Corrected in W/m^2/sr/nm) Data	RO-X-OSINAC-4-CVP1-CHECKOUT-V1.0
/holdings/ro-x-osinac-4-cvp1-chkout-reflect-v1.0/	Rosetta-Orbiter OSIRIS Narrow Angle Camera Commission 1 & C/2002 T7 (LINEAR) Resampled-B (Geometric Distortion Corrected in Reflectance Units) Data	RO-X-OSINAC-4-CVP1-CHKOUT-REFLECT-V1.0
/holdings/ro-x-osinac-4-cvp1-chkout-strlight-v1.0/	Rosetta-Orbiter OSIRIS Narrow Angle Camera Commission 1 & C/2002 T7 (LINEAR) Resampled-C (Solar Stray Light and Geometric Distortion Corrected in W/m^2/sr/nm) Data	RO-X-OSINAC-4-CVP1-CHKOUT-STRLIGHT-V1.0
/holdings/ro-x-osinac-4-cvp1-chkout-str-refl-v1.0/	Rosetta-Orbiter OSIRIS Narrow Angle Camera Commission 1 & C/2002 T7 (LINEAR) Resampled-D (Solar Stray Light and Geometric Distortion Corrected in Reflectance Units) Data	RO-X-OSINAC-4-CVP1-CHKOUT-STR-REFL-V1.0
/holdings/ro-x-osiwac-2-cvp1-checkout-v1.0/	Rosetta-Orbiter OSIRIS Wide Angle Camera Commissioning 1 & C/2002 T7 (LINEAR) Raw Data	RO-X-OSIWAC-2-CVP1-CHECKOUT-V1.0
/holdings/ro-x-osiwac-3-cvp1-checkout-v1.0/	Rosetta-Orbiter OSIRIS Wide Angle Camera Commissioning 1 & C/2002 T7 (LINEAR) Calibrated Data	RO-X-OSIWAC-3-CVP1-CHECKOUT-V1.0
/holdings/ro-x-osiwac-4-cvp1-checkout-v1.0/	Rosetta-Orbiter OSIRIS Wide Angle Camera Commission 1 & C/2002 T7 (LINEAR) Resampled-A (Geometric Distortion Corrected in W/m^2/sr/nm) Data	RO-X-OSIWAC-4-CVP1-CHECKOUT-V1.0
/holdings/ro-x-osiwac-4-cvp1-chkout-reflect-v1.0/	Rosetta-Orbiter OSIRIS Wide Angle Camera Commission 1 & C/2002 T7 (LINEAR) Resampled-B (Geometric Distortion Corrected in Reflectance Units) Data	RO-X-OSIWAC-4-CVP1-CHKOUT-REFLECT-V1.0
/holdings/ro-x-osiwac-4-cvp1-chkout-strlight-v1.0/	Rosetta-Orbiter OSIRIS Wide Angle Camera Commission 1 & C/2002 T7 (LINEAR) Resampled-C (Solar Stray Light and Geometric Distortion Corrected in W/m^2/sr/nm) Data	RO-X-OSIWAC-4-CVP1-CHKOUT-STRLIGHT-V1.0
/holdings/ro-x-osiwac-4-cvp1-chkout-str-refl-v1.0/	Rosetta-Orbiter OSIRIS Wide Angle Camera Commission 1 & C/2002 T7 (LINEAR) Resampled-D (Solar Stray Light and Geometric Distortion Corrected in Reflectance Units) Data	RO-X-OSIWAC-4-CVP1-CHKOUT-STR-REFL-V1.0
/holdings/ro-x-osinac-2-cr1-checkout-v1.0/	Rosetta-Orbiter OSIRIS Narrow Angle Camera Cruise 1 Raw Data	RO-X-OSINAC-2-CR1-CHECKOUT-V1.0
/holdings/ro-x-osiwac-2-cr1-checkout-v1.0/	Rosetta-Orbiter OSIRIS Wide Angle Camera Cruise 1 Raw Data	RO-X-OSIWAC-2-CR1-CHECKOUT-V1.0
/holdings/ro-x-osinac-2-cvp2-checkout-v1.0/	Rosetta-Orbiter OSIRIS Narrow Angle Camera Commissioning 2 Raw Data	RO-X-OSINAC-2-CVP2-CHECKOUT-V1.0
/holdings/ro-x-osinac-3-cvp2-checkout-v1.0/	Rosetta-Orbiter OSIRIS Narrow Angle Camera Commissioning 2 Calibrated Data	RO-X-OSINAC-3-CVP2-CHECKOUT-V1.0
/holdings/ro-x-osinac-4-cvp2-checkout-v1.0/	Rosetta-Orbiter OSIRIS Narrow Angle Camera Commission 2 Resampled-A (Geometric Distortion Corrected in W/m^2/sr/nm) Data	RO-X-OSINAC-4-CVP2-CHECKOUT-V1.0
/holdings/ro-x-osinac-4-cvp2-chkout-reflect-v1.0/	Rosetta-Orbiter OSIRIS Narrow Angle Camera Commission 2 Resampled-B (Geometric Distortion Corrected in Reflectance Units) Data	RO-X-OSINAC-4-CVP2-CHKOUT-REFLECT-V1.0
/holdings/ro-x-osinac-4-cvp2-chkout-strlight-v1.0/	Rosetta-Orbiter OSIRIS Narrow Angle Camera Commission 2 Resampled-C (Solar Stray Light and Geometric Distortion Corrected in W/m^2/sr/nm) Data	RO-X-OSINAC-4-CVP2-CHKOUT-STRLIGHT-V1.0
/holdings/ro-x-osinac-4-cvp2-chkout-str-refl-v1.0/	Rosetta-Orbiter OSIRIS Narrow Angle Camera Commission 2 Resampled-D (Solar Stray Light and Geometric Distortion Corrected in Reflectance Units) Data	RO-X-OSINAC-4-CVP2-CHKOUT-STR-REFL-V1.0
/holdings/ro-x-osiwac-2-cvp2-checkout-v1.0/	Rosetta-Orbiter OSIRIS Wide Angle Camera Commissioning 2 Raw Data	RO-X-OSIWAC-2-CVP2-CHECKOUT-V1.0
/holdings/ro-x-osiwac-3-cvp2-checkout-v1.0/	Rosetta-Orbiter OSIRIS Wide Angle Camera Commissioning 2 Calibrated Data	RO-X-OSIWAC-3-CVP2-CHECKOUT-V1.0
/holdings/ro-x-osiwac-4-cvp2-checkout-v1.0/	Rosetta-Orbiter OSIRIS Wide Angle Camera Commission 2 Resampled-A (Geometric Distortion Corrected in W/m^2/sr/nm) Data	RO-X-OSIWAC-4-CVP2-CHECKOUT-V1.0
/holdings/ro-x-osiwac-4-cvp2-chkout-reflect-v1.0/	Rosetta-Orbiter OSIRIS Wide Angle Camera Commission 2 Resampled-B (Geometric Distortion Corrected in Reflectance Units) Data	RO-X-OSIWAC-4-CVP2-CHKOUT-REFLECT-V1.0
/holdings/ro-x-osiwac-4-cvp2-chkout-strlight-v1.0/	Rosetta-Orbiter OSIRIS Wide Angle Camera Commission 2 Resampled-C (Solar Stray Light and Geometric Distortion Corrected in W/m^2/sr/nm) Data	RO-X-OSIWAC-4-CVP2-CHKOUT-STRLIGHT-V1.0
/holdings/ro-x-osiwac-4-cvp2-chkout-str-refl-v1.0/	Rosetta-Orbiter OSIRIS Wide Angle Camera Commission 2 Resampled-D (Solar Stray Light and Geometric Distortion Corrected in Reflectance Units) Data	RO-X-OSIWAC-4-CVP2-CHKOUT-STR-REFL-V1.0
/holdings/ro-e-osinac-2-ear1-earthswingby1-v2.0/	Rosetta-Orbiter OSIRIS Narrow Angle Camera Earth Swing-by 1 Raw Data v2.0	RO-E-OSINAC-2-EAR1-EARTHSWINGBY1-V2.0
/holdings/ro-e-osinac-3-ear1-earthswingby1-v2.0/	Rosetta-Orbiter OSIRIS Narrow Angle Camera Earth Swing-by 1 Calibrated Data v2.0	RO-E-OSINAC-3-EAR1-EARTHSWINGBY1-V2.0
/holdings/ro-e-osinac-4-ear1-earthswingby1-v1.0/	Rosetta-Orbiter OSIRIS Narrow Angle Camera Earth Swing-by 1 Resampled-A (Geometric Distortion Corrected in W/m^2/sr/nm) Data	RO-E-OSINAC-4-EAR1-EARTHSWINGBY1-V1.0
/holdings/ro-e-osinac-4-ear1-earth-reflect-v1.0/	Rosetta-Orbiter OSIRIS Narrow Angle Camera Earth Swing-by 1 Resampled-B (Geometric Distortion Corrected in Reflectance Units) Data	RO-E-OSINAC-4-EAR1-EARTH-REFLECT-V1.0
/holdings/ro-e-osinac-4-ear1-earth-strlight-v1.0/	Rosetta-Orbiter OSIRIS Narrow Angle Camera Earth Swing-by 1 Resampled-C (Solar Stray Light and Geometric Distortion Corrected in W/m^2/sr/nm) Data	RO-E-OSINAC-4-EAR1-EARTH-STRLIGHT-V1.0
/holdings/ro-e-osinac-4-ear1-earth-str-refl-v1.0/	Rosetta-Orbiter OSIRIS Narrow Angle Camera Earth Swing-by 1 Resampled-D (Solar Stray Light and Geometric Distortion Corrected in Reflectance Units) Data	RO-E-OSINAC-4-EAR1-EARTH-STR-REFL-V1.0
/holdings/ro-e-osiwac-2-ear1-earthswingby1-v2.0/	Rosetta-Orbiter OSIRIS Wide Angle Camera Earth Swing-by 1 Raw Data v2.0	RO-E-OSIWAC-2-EAR1-EARTHSWINGBY1-V2.0
/holdings/ro-e-osiwac-3-ear1-earthswingby1-v2.0/	Rosetta-Orbiter OSIRIS Wide Angle Camera Earth Swing-by 1 Calibrated Data v2.0	RO-E-OSIWAC-3-EAR1-EARTHSWINGBY1-V2.0
/holdings/ro-e-osiwac-4-ear1-earthswingby1-v1.0/	Rosetta-Orbiter OSIRIS Wide Angle Camera Earth Swing-by 1 Resampled-A (Geometric Distortion Corrected in W/m^2/sr/nm) Data	RO-E-OSIWAC-4-EAR1-EARTHSWINGBY1-V1.0
/holdings/ro-e-osiwac-4-ear1-earth-reflect-v1.0/	Rosetta-Orbiter OSIRIS Wide Angle Camera Earth Swing-by 1 Resampled-B (Geometric Distortion Corrected in Reflectance Units) Data	RO-E-OSIWAC-4-EAR1-EARTH-REFLECT-V1.0
/holdings/ro-e-osiwac-4-ear1-earth-strlight-v1.0/	Rosetta-Orbiter OSIRIS Wide Angle Camera Earth Swing-by 1 Resampled-C (Solar Stray Light and Geometric Distortion Corrected in W/m^2/sr/nm) Data	RO-E-OSIWAC-4-EAR1-EARTH-STRLIGHT-V1.0
/holdings/ro-e-osiwac-4-ear1-earth-str-refl-v1.0/	Rosetta-Orbiter OSIRIS Wide Angle Camera Earth Swing-by 1 Resampled-D (Solar Stray Light and Geometric Distortion Corrected in Reflectance Units) Data	RO-E-OSIWAC-4-EAR1-EARTH-STR-REFL-V1.0
/holdings/ro-x-osinac-2-cr2-checkout-v2.0/	Rosetta-Orbiter OSIRIS Narrow Angle Camera Cruise 2 & 9P/Tempel 1 Raw Data v2.0	RO-X-OSINAC-2-CR2-CHECKOUT-V2.0
/holdings/ro-x-osinac-3-cr2-checkout-v2.0/	Rosetta-Orbiter OSIRIS Narrow Angle Camera Cruise 2 & 9P/Tempel 1 Calibrated Data v2.0	RO-X-OSINAC-3-CR2-CHECKOUT-V2.0
/holdings/ro-x-osinac-4-cr2-checkout-v1.0/	Rosetta-Orbiter OSIRIS Narrow Angle Camera Cruise 2 & 9P/Tempel 1 Resampled-A (Geometric Distortion Corrected in W/m^2/sr/nm) Data	RO-X-OSINAC-4-CR2-CHECKOUT-V1.0
/holdings/ro-x-osinac-4-cr2-chkout-reflect-v1.0/	Rosetta-Orbiter OSIRIS Narrow Angle Camera Cruise 2 & 9P/Tempel 1 Resampled-B (Geometric Distortion Corrected in Reflectance Units) Data	RO-X-OSINAC-4-CR2-CHKOUT-REFLECT-V1.0
/holdings/ro-x-osinac-4-cr2-chkout-strlight-v1.0/	Rosetta-Orbiter OSIRIS Narrow Angle Camera Cruise 2 & 9P/Tempel 1 Resampled-C (Solar Stray Light and Geometric Distortion Corrected in W/m^2/sr/nm) Data	RO-X-OSINAC-4-CR2-CHKOUT-STRLIGHT-V1.0
/holdings/ro-x-osinac-4-cr2-chkout-str-refl-v1.0/	Rosetta-Orbiter OSIRIS Narrow Angle Camera Cruise 2 & 9P/Tempel 1 Resampled-D (Solar Stray Light and Geometric Distortion Corrected in Reflectance Units) Data	RO-X-OSINAC-4-CR2-CHKOUT-STR-REFL-V1.0
/holdings/ro-x-osiwac-2-cr2-checkout-v2.0/	Rosetta-Orbiter OSIRIS Wide Angle Camera Cruise 2 & 9P/Tempel 1 Raw Data v2.0	RO-X-OSIWAC-2-CR2-CHECKOUT-V2.0
/holdings/ro-x-osiwac-3-cr2-checkout-v2.0/	Rosetta-Orbiter OSIRIS Wide Angle Camera Cruise 2 & 9P/Tempel 1 Calibrated Data v2.0	RO-X-OSIWAC-3-CR2-CHECKOUT-V2.0
/holdings/ro-x-osiwac-4-cr2-checkout-v1.0/	Rosetta-Orbiter OSIRIS Wide Angle Camera Cruise 2 & 9P/Tempel 1 Resampled-A (Geometric Distortion Corrected in W/m^2/sr/nm) Data	RO-X-OSIWAC-4-CR2-CHECKOUT-V1.0
/holdings/ro-x-osiwac-4-cr2-chkout-reflect-v1.0/	Rosetta-Orbiter OSIRIS Wide Angle Camera Cruise 2 & 9P/Tempel 1 Resampled-B (Geometric Distortion Corrected in Reflectance Units) Data	RO-X-OSIWAC-4-CR2-CHKOUT-REFLECT-V1.0
/holdings/ro-x-osiwac-4-cr2-chkout-strlight-v1.0/	Rosetta-Orbiter OSIRIS Wide Angle Camera Cruise 2 & 9P/Tempel 1 Resampled-C (Solar Stray Light and Geometric Distortion Corrected in W/m^2/sr/nm) Data	RO-X-OSIWAC-4-CR2-CHKOUT-STRLIGHT-V1.0
/holdings/ro-x-osiwac-4-cr2-chkout-str-refl-v1.0/	Rosetta-Orbiter OSIRIS Wide Angle Camera Cruise 2 & 9P/Tempel 1 Resampled-D (Solar Stray Light and Geometric Distortion Corrected in Reflectance Units) Data	RO-X-OSIWAC-4-CR2-CHKOUT-STR-REFL-V1.0
/holdings/ro-m-osinac-2-mars-marsswingby-v2.0/	Rosetta-Orbiter OSIRIS Narrow Angle Camera Mars Swing-by Raw Data v2.0	RO-M-OSINAC-2-MARS-MARSSWINGBY-V2.0
/holdings/ro-m-osinac-3-mars-marsswingby-v2.0/	Rosetta-Orbiter OSIRIS Narrow Angle Camera Mars Swing-by Calibrated Data v2.0	RO-M-OSINAC-3-MARS-MARSSWINGBY-V2.0
/holdings/ro-m-osinac-4-mars-marsswingby-v1.0/	Rosetta-Orbiter OSIRIS Narrow Angle Camera Mars Swing-by Resampled-A (Geometric Distortion Corrected in W/m^2/sr/nm) Data	RO-M-OSINAC-4-MARS-MARSSWINGBY-V1.0
/holdings/ro-m-osinac-4-mars-mars-reflect-v1.0/	Rosetta-Orbiter OSIRIS Narrow Angle Camera Mars Swing-by Resampled-B (Geometric Distortion Corrected in Reflectance Units) Data	RO-M-OSINAC-4-MARS-MARS-REFLECT-V1.0
/holdings/ro-m-osinac-4-mars-mars-strlight-v1.0/	Rosetta-Orbiter OSIRIS Narrow Angle Camera Mars Swing-by Resampled-C (Solar Stray Light and Geometric Distortion Corrected in W/m^2/sr/nm) Data	RO-M-OSINAC-4-MARS-MARS-STRLIGHT-V1.0
/holdings/ro-m-osinac-4-mars-mars-str-refl-v1.0/	Rosetta-Orbiter OSIRIS Narrow Angle Camera Mars Swing-by Resampled-D (Solar Stray Light and Geometric Distortion Corrected in Reflectance Units) Data	RO-M-OSINAC-4-MARS-MARS-STR-REFL-V1.0
/holdings/ro-m-osiwac-2-mars-marsswingby-v2.0/	Rosetta-Orbiter OSIRIS Wide Angle Camera Mars Swing-by Raw Data v2.0	RO-M-OSIWAC-2-MARS-MARSSWINGBY-V2.0
/holdings/ro-m-osiwac-3-mars-marsswingby-v2.0/	Rosetta-Orbiter OSIRIS Wide Angle Camera Mars Swing-by Calibrated Data v2.0	RO-M-OSIWAC-3-MARS-MARSSWINGBY-V2.0
/holdings/ro-m-osiwac-4-mars-marsswingby-v1.0/	Rosetta-Orbiter OSIRIS Wide Angle Camera Mars Swing-by Resampled-A (Geometric Distortion Corrected in W/m^2/sr/nm) Data	RO-M-OSIWAC-4-MARS-MARSSWINGBY-V1.0
/holdings/ro-m-osiwac-4-mars-mars-reflect-v1.0/	Rosetta-Orbiter OSIRIS Wide Angle Camera Mars Swing-by Resampled-B (Geometric Distortion Corrected in Reflectance Units) Data	RO-M-OSIWAC-4-MARS-MARS-REFLECT-V1.0
/holdings/ro-m-osiwac-4-mars-mars-strlight-v1.0/	Rosetta-Orbiter OSIRIS Wide Angle Camera Mars Swing-by Resampled-C (Solar Stray Light and Geometric Distortion Corrected in W/m^2/sr/nm) Data	RO-M-OSIWAC-4-MARS-MARS-STRLIGHT-V1.0
/holdings/ro-m-osiwac-4-mars-mars-str-refl-v1.0/	Rosetta-Orbiter OSIRIS Wide Angle Camera Mars Swing-by Resampled-D (Solar Stray Light and Geometric Distortion Corrected in Reflectance Units) Data	RO-M-OSIWAC-4-MARS-MARS-STR-REFL-V1.0
/holdings/ro-e-osinac-2-ear2-earthswingby2-v2.0/	Rosetta-Orbiter OSIRIS Narrow Angle Camera Earth Swing-by 2 Raw Data v2.0	RO-E-OSINAC-2-EAR2-EARTHSWINGBY2-V2.0
/holdings/ro-e-osinac-3-ear2-earthswingby2-v2.0/	Rosetta-Orbiter OSIRIS Narrow Angle Camera Earth Swing-by 2 Calibrated Data v2.0	RO-E-OSINAC-3-EAR2-EARTHSWINGBY2-V2.0
/holdings/ro-e-osinac-4-ear2-earthswingby2-v1.0/	Rosetta-Orbiter OSIRIS Narrow Angle Camera Earth Swing-by 2 Resampled-A (Geometric Distortion Corrected in W/m^2/sr/nm) Data	RO-E-OSINAC-4-EAR2-EARTHSWINGBY2-V1.0
/holdings/ro-e-osinac-4-ear2-earth-reflect-v1.0/	Rosetta-Orbiter OSIRIS Narrow Angle Camera Earth Swing-by 2 Resampled-B (Geometric Distortion Corrected in Reflectance Units) Data	RO-E-OSINAC-4-EAR2-EARTH-REFLECT-V1.0
/holdings/ro-e-osinac-4-ear2-earth-strlight-v1.0/	Rosetta-Orbiter OSIRIS Narrow Angle Camera Earth Swing-by 2 Resampled-C (Solar Stray Light and Geometric Distortion Corrected in W/m^2/sr/nm) Data	RO-E-OSINAC-4-EAR2-EARTH-STRLIGHT-V1.0
/holdings/ro-e-osinac-4-ear2-earth-str-refl-v1.0/	Rosetta-Orbiter OSIRIS Narrow Angle Camera Earth Swing-by 2 Resampled-D (Solar Stray Light and Geometric Distortion Corrected in Reflectance Units) Data	RO-E-OSINAC-4-EAR2-EARTH-STR-REFL-V1.0
/holdings/ro-e-osiwac-2-ear2-earthswingby2-v2.0/	Rosetta-Orbiter OSIRIS Wide Angle Camera Earth Swing-by 2 Raw Data v2.0	RO-E-OSIWAC-2-EAR2-EARTHSWINGBY2-V2.0
/holdings/ro-e-osiwac-3-ear2-earthswingby2-v2.0/	Rosetta-Orbiter OSIRIS Wide Angle Camera Earth Swing-by 2 Calibrated Data v2.0	RO-E-OSIWAC-3-EAR2-EARTHSWINGBY2-V2.0
/holdings/ro-e-osiwac-4-ear2-earthswingby2-v1.0/	Rosetta-Orbiter OSIRIS Wide Angle Camera Earth Swing-by 2 Resampled-A (Geometric Distortion Corrected in W/m^2/sr/nm) Data	RO-E-OSIWAC-4-EAR2-EARTHSWINGBY2-V1.0
/holdings/ro-e-osiwac-4-ear2-earth-reflect-v1.0/	Rosetta-Orbiter OSIRIS Wide Angle Camera Earth Swing-by 2 Resampled-B (Geometric Distortion Corrected in Reflectance Units) Data	RO-E-OSIWAC-4-EAR2-EARTH-REFLECT-V1.0
/holdings/ro-e-osiwac-4-ear2-earth-strlight-v1.0/	Rosetta-Orbiter OSIRIS Wide Angle Camera Earth Swing-by 2 Resampled-C (Solar Stray Light and Geometric Distortion Corrected in W/m^2/sr/nm) Data	RO-E-OSIWAC-4-EAR2-EARTH-STRLIGHT-V1.0
/holdings/ro-e-osiwac-4-ear2-earth-str-refl-v1.0/	Rosetta-Orbiter OSIRIS Wide Angle Camera Earth Swing-by 2 Resampled-D (Solar Stray Light and Geometric Distortion Corrected in Reflectance Units) Data	RO-E-OSIWAC-4-EAR2-EARTH-STR-REFL-V1.0
/holdings/ro-x-osinac-2-cr4a-checkout-v2.0/	Rosetta-Orbiter OSIRIS Narrow Angle Camera Cruise 4A Raw Data v2.0	RO-X-OSINAC-2-CR4A-CHECKOUT-V2.0
/holdings/ro-x-osinac-3-cr4a-checkout-v2.0/	Rosetta-Orbiter OSIRIS Narrow Angle Camera Cruise 4A Calibrated Data v2.0	RO-X-OSINAC-3-CR4A-CHECKOUT-V2.0
/holdings/ro-x-osinac-4-cr4a-checkout-v1.0/	Rosetta-Orbiter OSIRIS Narrow Angle Camera Cruise 4A Resampled-A (Geometric Distortion Corrected in W/m^2/sr/nm) Data	RO-X-OSINAC-4-CR4A-CHECKOUT-V1.0
/holdings/ro-x-osinac-4-cr4a-chkout-reflect-v1.0/	Rosetta-Orbiter OSIRIS Narrow Angle Camera Cruise 4A Resampled-B (Geometric Distortion Corrected in Reflectance Units) Data	RO-X-OSINAC-4-CR4A-CHKOUT-REFLECT-V1.0
/holdings/ro-x-osinac-4-cr4a-chkout-strlight-v1.0/	Rosetta-Orbiter OSIRIS Narrow Angle Camera Cruise 4A Resampled-C (Solar Stray Light and Geometric Distortion Corrected in W/m^2/sr/nm) Data	RO-X-OSINAC-4-CR4A-CHKOUT-STRLIGHT-V1.0
/holdings/ro-x-osinac-4-cr4a-chkout-str-refl-v1.0/	Rosetta-Orbiter OSIRIS Narrow Angle Camera Cruise 4A Resampled-D (Solar Stray Light and Geometric Distortion Corrected in Reflectance Units) Data	RO-X-OSINAC-4-CR4A-CHKOUT-STR-REFL-V1.0
/holdings/ro-x-osiwac-2-cr4a-checkout-v2.0/	Rosetta-Orbiter OSIRIS Wide Angle Camera Cruise 4A Raw Data v2.0	RO-X-OSIWAC-2-CR4A-CHECKOUT-V2.0
/holdings/ro-x-osiwac-3-cr4a-checkout-v2.0/	Rosetta-Orbiter OSIRIS Wide Angle Camera Cruise 4A Calibrated Data v2.0	RO-X-OSIWAC-3-CR4A-CHECKOUT-V2.0
/holdings/ro-x-osiwac-4-cr4a-checkout-v1.0/	Rosetta-Orbiter OSIRIS Wide Angle Camera Cruise 4A Resampled-A (Geometric Distortion Corrected in W/m^2/sr/nm) Data	RO-X-OSIWAC-4-CR4A-CHECKOUT-V1.0
/holdings/ro-x-osiwac-4-cr4a-chkout-reflect-v1.0/	Rosetta-Orbiter OSIRIS Wide Angle Camera Cruise 4A Resampled-B (Geometric Distortion Corrected in Reflectance Units) Data	RO-X-OSIWAC-4-CR4A-CHKOUT-REFLECT-V1.0
/holdings/ro-x-osiwac-4-cr4a-chkout-strlight-v1.0/	Rosetta-Orbiter OSIRIS Wide Angle Camera Cruise 4A Resampled-C (Solar Stray Light and Geometric Distortion Corrected in W/m^2/sr/nm) Data	RO-X-OSIWAC-4-CR4A-CHKOUT-STRLIGHT-V1.0
/holdings/ro-x-osiwac-4-cr4a-chkout-str-refl-v1.0/	Rosetta-Orbiter OSIRIS Wide Angle Camera Cruise 4A Resampled-D (Solar Stray Light and Geometric Distortion Corrected in Reflectance Units) Data	RO-X-OSIWAC-4-CR4A-CHKOUT-STR-REFL-V1.0
/holdings/ro-a-osinac-2-ast1-steinsflyby-v2.0/	Rosetta-Orbiter OSIRIS Narrow Angle Camera Steins Raw Data v2.0	RO-A-OSINAC-2-AST1-STEINSFLYBY-V2.0
/holdings/ro-a-osinac-3-ast1-steinsflyby-v2.0/	Rosetta-Orbiter OSIRIS Narrow Angle Camera Steins Calibrated Data v2.0	RO-A-OSINAC-3-AST1-STEINSFLYBY-V2.0
/holdings/ro-a-osinac-4-ast1-steinsflyby-v1.0/	Rosetta-Orbiter OSIRIS Narrow Angle Camera Steins Resampled-A (Geometric Distortion Corrected in W/m^2/sr/nm) Data	RO-A-OSINAC-4-AST1-STEINSFLYBY-V1.0
/holdings/ro-a-osinac-4-ast1-steins-reflect-v1.0/	Rosetta-Orbiter OSIRIS Narrow Angle Camera Steins Resampled-B (Geometric Distortion Corrected in Reflectance Units) Data	RO-A-OSINAC-4-AST1-STEINS-REFLECT-V1.0
/holdings/ro-a-osinac-4-ast1-steins-strlight-v1.0/	Rosetta-Orbiter OSIRIS Narrow Angle Camera Steins Resampled-C (Solar Stray Light and Geometric Distortion Corrected in W/m^2/sr/nm) Data	RO-A-OSINAC-4-AST1-STEINS-STRLIGHT-V1.0
/holdings/ro-a-osinac-4-ast1-steins-str-refl-v1.0/	Rosetta-Orbiter OSIRIS Narrow Angle Camera Steins Resampled-D (Solar Stray Light and Geometric Distortion Corrected in Reflectance Units) Data	RO-A-OSINAC-4-AST1-STEINS-STR-REFL-V1.0
/holdings/ro-a-osiwac-2-ast1-steinsflyby-v2.0/	Rosetta-Orbiter OSIRIS Wide Angle Camera Steins Raw Data v2.0	RO-A-OSIWAC-2-AST1-STEINSFLYBY-V2.0
/holdings/ro-a-osiwac-3-ast1-steinsflyby-v2.0/	Rosetta-Orbiter OSIRIS Wide Angle Camera Steins Calibrated Data v2.0	RO-A-OSIWAC-3-AST1-STEINSFLYBY-V2.0
/holdings/ro-a-osiwac-4-ast1-steinsflyby-v1.0/	Rosetta-Orbiter OSIRIS Wide Angle Camera Steins Resampled-A (Geometric Distortion Corrected in W/m^2/sr/nm) Data	RO-A-OSIWAC-4-AST1-STEINSFLYBY-V1.0
/holdings/ro-a-osiwac-4-ast1-steins-reflect-v1.0/	Rosetta-Orbiter OSIRIS Wide Angle Camera Steins Resampled-B (Geometric Distortion Corrected in Reflectance Units) Data	RO-A-OSIWAC-4-AST1-STEINS-REFLECT-V1.0
/holdings/ro-a-osiwac-4-ast1-steins-strlight-v1.0/	Rosetta-Orbiter OSIRIS Wide Angle Camera Steins Resampled-C (Solar Stray Light and Geometric Distortion Corrected in W/m^2/sr/nm) Data	RO-A-OSIWAC-4-AST1-STEINS-STRLIGHT-V1.0
/holdings/ro-a-osiwac-4-ast1-steins-str-refl-v1.0/	Rosetta-Orbiter OSIRIS Wide Angle Camera Steins Resampled-D (Solar Stray Light and Geometric Distortion Corrected in Reflectance Units) Data	RO-A-OSIWAC-4-AST1-STEINS-STR-REFL-V1.0
/holdings/ro-x-osinac-2-cr4b-checkout-v2.0/	Rosetta-Orbiter OSIRIS Narrow Angle Camera Cruise 4B Raw Data v2.0	RO-X-OSINAC-2-CR4B-CHECKOUT-V2.0
/holdings/ro-x-osinac-3-cr4b-cruise4b-v1.4/	Rosetta-Orbiter OSIRIS Narrow Angle Camera Cruise 4B Calibrated Data	RO-X-OSINAC-3-CR4B-CRUISE4B-V1.4
/holdings/ro-x-osiwac-2-cr4b-checkout-v2.0/	Rosetta-Orbiter OSIRIS Wide Angle Camera Cruise 4B Raw Data v2.0	RO-X-OSIWAC-2-CR4B-CHECKOUT-V2.0
/holdings/ro-e-osinac-2-ear3-earthswingby3-v2.0/	Rosetta-Orbiter OSIRIS Narrow Angle Camera Earth Swing-by 3 Raw Data v2.0	RO-E-OSINAC-2-EAR3-EARTHSWINGBY3-V2.0
/holdings/ro-e-osinac-3-ear3-earthswingby3-v2.0/	Rosetta-Orbiter OSIRIS Narrow Angle Camera Earth Swing-by 3 Calibrated Data v2.0	RO-E-OSINAC-3-EAR3-EARTHSWINGBY3-V2.0
/holdings/ro-e-osinac-4-ear3-earthswingby3-v1.0/	Rosetta-Orbiter OSIRIS Narrow Angle Camera Earth Swing-by 3 Resampled-A (Geometric Distortion Corrected in W/m^2/sr/nm) Data	RO-E-OSINAC-4-EAR3-EARTHSWINGBY3-V1.0
/holdings/ro-e-osinac-4-ear3-earth-reflect-v1.0/	Rosetta-Orbiter OSIRIS Narrow Angle Camera Earth Swing-by 3 Resampled-B (Geometric Distortion Corrected in Reflectance Units) Data	RO-E-OSINAC-4-EAR3-EARTH-REFLECT-V1.0
/holdings/ro-e-osinac-4-ear3-earth-strlight-v1.0/	Rosetta-Orbiter OSIRIS Narrow Angle Camera Earth Swing-by 3 Resampled-C (Solar Stray Light and Geometric Distortion Corrected in W/m^2/sr/nm) Data	RO-E-OSINAC-4-EAR3-EARTH-STRLIGHT-V1.0
/holdings/ro-e-osinac-4-ear3-earth-str-refl-v1.0/	Rosetta-Orbiter OSIRIS Narrow Angle Camera Earth Swing-by 3 Resampled-D (Solar Stray Light and Geometric Distortion Corrected in Reflectance Units) Data	RO-E-OSINAC-4-EAR3-EARTH-STR-REFL-V1.0
/holdings/ro-e-osiwac-2-ear3-earthswingby3-v2.0/	Rosetta-Orbiter OSIRIS Wide Angle Camera Earth Swing-by 3 Raw Data v2.0	RO-E-OSIWAC-2-EAR3-EARTHSWINGBY3-V2.0
/holdings/ro-e-osiwac-3-ear3-earthswingby3-v2.0/	Rosetta-Orbiter OSIRIS Wide Angle Camera Earth Swing-by 3 Calibrated Data v2.0	RO-E-OSIWAC-3-EAR3-EARTHSWINGBY3-V2.0
/holdings/ro-e-osiwac-4-ear3-earthswingby3-v1.0/	Rosetta-Orbiter OSIRIS Wide Angle Camera Earth Swing-by 3 Resampled-A (Geometric Distortion Corrected in W/m^2/sr/nm) Data	RO-E-OSIWAC-4-EAR3-EARTHSWINGBY3-V1.0
/holdings/ro-e-osiwac-4-ear3-earth-reflect-v1.0/	Rosetta-Orbiter OSIRIS Wide Angle Camera Earth Swing-by 3 Resampled-B (Geometric Distortion Corrected in Reflectance Units) Data	RO-E-OSIWAC-4-EAR3-EARTH-REFLECT-V1.0
/holdings/ro-e-osiwac-4-ear3-earth-strlight-v1.0/	Rosetta-Orbiter OSIRIS Wide Angle Camera Earth Swing-by 3 Resampled-C (Solar Stray Light and Geometric Distortion Corrected in W/m^2/sr/nm) Data	RO-E-OSIWAC-4-EAR3-EARTH-STRLIGHT-V1.0
/holdings/ro-e-osiwac-4-ear3-earth-str-refl-v1.0/	Rosetta-Orbiter OSIRIS Wide Angle Camera Earth Swing-by 3 Resampled-D (Solar Stray Light and Geometric Distortion Corrected in Reflectance Units) Data	RO-E-OSIWAC-4-EAR3-EARTH-STR-REFL-V1.0
/holdings/ro-x-osinac-2-cr5-checkout-v2.0/	Rosetta-Orbiter OSIRIS Narrow Angle Camera Cruise 5 Raw Data v2.0	RO-X-OSINAC-2-CR5-CHECKOUT-V2.0
/holdings/ro-x-osinac-3-cr5-checkout-v2.0/	Rosetta-Orbiter OSIRIS Narrow Angle Camera Cruise 5 Calibrated Data v2.0	RO-X-OSINAC-3-CR5-CHECKOUT-V2.0
/holdings/ro-x-osinac-4-cr5-checkout-v1.0/	Rosetta-Orbiter OSIRIS Narrow Angle Camera Cruise 5 Resampled-A (Geometric Distortion Corrected in W/m^2/sr/nm) Data	RO-X-OSINAC-4-CR5-CHECKOUT-V1.0
/holdings/ro-x-osinac-4-cr5-chkout-reflect-v1.0/	Rosetta-Orbiter OSIRIS Narrow Angle Camera Cruise 5 Resampled-B (Geometric Distortion Corrected in Reflectance Units) Data	RO-X-OSINAC-4-CR5-CHKOUT-REFLECT-V1.0
/holdings/ro-x-osinac-4-cr5-chkout-strlight-v1.0/	Rosetta-Orbiter OSIRIS Narrow Angle Camera Cruise 5 Resampled-C (Solar Stray Light and Geometric Distortion Corrected in W/m^2/sr/nm) Data	RO-X-OSINAC-4-CR5-CHKOUT-STRLIGHT-V1.0
/holdings/ro-x-osinac-4-cr5-chkout-str-refl-v1.0/	Rosetta-Orbiter OSIRIS Narrow Angle Camera Cruise 5 Resampled-D (Solar Stray Light and Geometric Distortion Corrected in Reflectance Units) Data	RO-X-OSINAC-4-CR5-CHKOUT-STR-REFL-V1.0
/holdings/ro-x-osiwac-2-cr5-checkout-v2.0/	Rosetta-Orbiter OSIRIS Wide Angle Camera Cruise 5 Raw Data v2.0	RO-X-OSIWAC-2-CR5-CHECKOUT-V2.0
/holdings/ro-x-osiwac-3-cr5-checkout-v2.0/	Rosetta-Orbiter OSIRIS Wide Angle Camera Cruise 5 Calibrated Data v2.0	RO-X-OSIWAC-3-CR5-CHECKOUT-V2.0
/holdings/ro-x-osiwac-4-cr5-checkout-v1.0/	Rosetta-Orbiter OSIRIS Wide Angle Camera Cruise 5 Resampled-A (Geometric Distortion Corrected in W/m^2/sr/nm) Data	RO-X-OSIWAC-4-CR5-CHECKOUT-V1.0
/holdings/ro-x-osiwac-4-cr5-chkout-reflect-v1.0/	Rosetta-Orbiter OSIRIS Wide Angle Camera Cruise 5 Resampled-B (Geometric Distortion Corrected in Reflectance Units) Data	RO-X-OSIWAC-4-CR5-CHKOUT-REFLECT-V1.0
/holdings/ro-x-osiwac-4-cr5-chkout-strlight-v1.0/	Rosetta-Orbiter OSIRIS Wide Angle Camera Cruise 5 Resampled-C (Solar Stray Light and Geometric Distortion Corrected in W/m^2/sr/nm) Data	RO-X-OSIWAC-4-CR5-CHKOUT-STRLIGHT-V1.0
/holdings/ro-x-osiwac-4-cr5-chkout-str-refl-v1.0/	Rosetta-Orbiter OSIRIS Wide Angle Camera Cruise 5 Resampled-D (Solar Stray Light and Geometric Distortion Corrected in Reflectance Units) Data	RO-X-OSIWAC-4-CR5-CHKOUT-STR-REFL-V1.0
/holdings/ro-a-osinac-2-ast2-lutetiaflyby-v2.0/	Rosetta-Orbiter OSIRIS Narrow Angle Camera Lutetia Raw Data v2.0	RO-A-OSINAC-2-AST2-LUTETIAFLYBY-V2.0
/holdings/ro-a-osinac-3-ast2-lutetiaflyby-v2.0/	Rosetta-Orbiter OSIRIS Narrow Angle Camera Lutetia Calibrated Data v2.0	RO-A-OSINAC-3-AST2-LUTETIAFLYBY-V2.0
/holdings/ro-a-osinac-4-ast2-lutetiaflyby-v1.0/	Rosetta-Orbiter OSIRIS Narrow Angle Camera Lutetia Resampled-A (Geometric Distortion Corrected in W/m^2/sr/nm) Data	RO-A-OSINAC-4-AST2-LUTETIAFLYBY-V1.0
/holdings/ro-a-osinac-4-ast2-lutetia-reflect-v1.0/	Rosetta-Orbiter OSIRIS Narrow Angle Camera Lutetia Resampled-B (Geometric Distortion Corrected in Reflectance Units) Data	RO-A-OSINAC-4-AST2-LUTETIA-REFLECT-V1.0
/holdings/ro-a-osinac-4-ast2-lutetia-strlight-v1.0/	Rosetta-Orbiter OSIRIS Narrow Angle Camera Lutetia Resampled-C (Solar Stray Light and Geometric Distortion Corrected in W/m^2/sr/nm) Data	RO-A-OSINAC-4-AST2-LUTETIA-STRLIGHT-V1.0
/holdings/ro-a-osinac-4-ast2-lutetia-str-refl-v1.0/	Rosetta-Orbiter OSIRIS Narrow Angle Camera Lutetia Resampled-D (Solar Stray Light and Geometric Distortion Corrected in Reflectance Units) Data	RO-A-OSINAC-4-AST2-LUTETIA-STR-REFL-V1.0
/holdings/ro-a-osiwac-2-ast2-lutetiaflyby-v2.0/	Rosetta-Orbiter OSIRIS Wide Angle Camera Lutetia Raw Data v2.0	RO-A-OSIWAC-2-AST2-LUTETIAFLYBY-V2.0
/holdings/ro-a-osiwac-3-ast2-lutetiaflyby-v2.0/	Rosetta-Orbiter OSIRIS Wide Angle Camera Lutetia Calibrated Data v2.0	RO-A-OSIWAC-3-AST2-LUTETIAFLYBY-V2.0
/holdings/ro-a-osiwac-4-ast2-lutetiaflyby-v1.0/	Rosetta-Orbiter OSIRIS Wide Angle Camera Lutetia Resampled-A (Geometric Distortion Corrected in W/m^2/sr/nm) Data	RO-A-OSIWAC-4-AST2-LUTETIAFLYBY-V1.0
/holdings/ro-a-osiwac-4-ast2-lutetia-reflect-v1.0/	Rosetta-Orbiter OSIRIS Wide Angle Camera Lutetia Resampled-B (Geometric Distortion Corrected in Reflectance Units) Data	RO-A-OSIWAC-4-AST2-LUTETIA-REFLECT-V1.0
/holdings/ro-a-osiwac-4-ast2-lutetia-strlight-v1.0/	Rosetta-Orbiter OSIRIS Wide Angle Camera Lutetia Resampled-C (Solar Stray Light and Geometric Distortion Corrected in W/m^2/sr/nm) Data	RO-A-OSIWAC-4-AST2-LUTETIA-STRLIGHT-V1.0
/holdings/ro-a-osiwac-4-ast2-lutetia-str-refl-v1.0/	Rosetta-Orbiter OSIRIS Wide Angle Camera Lutetia Resampled-D (Solar Stray Light and Geometric Distortion Corrected in Reflectance Units) Data	RO-A-OSIWAC-4-AST2-LUTETIA-STR-REFL-V1.0
/holdings/ro-x-osinac-2-rvm1-checkout-v1.0/	Rosetta-Orbiter OSIRIS Narrow Angle Camera Rendezvous Maneuver 1 Raw Data	RO-X-OSINAC-2-RVM1-CHECKOUT-V1.0
/holdings/ro-x-osinac-3-rvm1-checkout-v1.0/	Rosetta-Orbiter OSIRIS Narrow Angle Camera Rendezvous Maneuver 1 Calibrated Data	RO-X-OSINAC-3-RVM1-CHECKOUT-V1.0
/holdings/ro-x-osinac-4-rvm1-checkout-v1.0/	Rosetta-Orbiter OSIRIS Narrow Angle Camera Rendezvous Maneuver 1 Resampled-A (Geometric Distortion Corrected in W/m^2/sr/nm) Data	RO-X-OSINAC-4-RVM1-CHECKOUT-V1.0
/holdings/ro-x-osinac-4-rvm1-chkout-reflect-v1.0/	Rosetta-Orbiter OSIRIS Narrow Angle Camera Rendezvous Maneuver 1 Resampled-B (Geometric Distortion Corrected in Reflectance Units) Data	RO-X-OSINAC-4-RVM1-CHKOUT-REFLECT-V1.0
/holdings/ro-x-osinac-4-rvm1-chkout-strlight-v1.0/	Rosetta-Orbiter OSIRIS Narrow Angle Camera Rendezvous Maneuver 1 Resampled-C (Solar Stray Light and Geometric Distortion Corrected in W/m^2/sr/nm) Data	RO-X-OSINAC-4-RVM1-CHKOUT-STRLIGHT-V1.0
/holdings/ro-x-osinac-4-rvm1-chkout-str-refl-v1.0/	Rosetta-Orbiter OSIRIS Narrow Angle Camera Rendezvous Maneuver 1 Resampled-D (Solar Stray Light and Geometric Distortion Corrected in Reflectance Units) Data	RO-X-OSINAC-4-RVM1-CHKOUT-STR-REFL-V1.0
/holdings/ro-x-osiwac-2-rvm1-checkout-v1.0/	Rosetta-Orbiter OSIRIS Wide Angle Camera Rendezvous Maneuver 1 Raw Data	RO-X-OSIWAC-2-RVM1-CHECKOUT-V1.0
/holdings/ro-x-osiwac-3-rvm1-checkout-v1.0/	Rosetta-Orbiter OSIRIS Wide Angle Camera Rendezvous Maneuver 1 Calibrated Data	RO-X-OSIWAC-3-RVM1-CHECKOUT-V1.0
/holdings/ro-x-osiwac-4-rvm1-checkout-v1.0/	Rosetta-Orbiter OSIRIS Wide Angle Camera Rendezvous Maneuver 1 Resampled-A (Geometric Distortion Corrected in W/m^2/sr/nm) Data	RO-X-OSIWAC-4-RVM1-CHECKOUT-V1.0
/holdings/ro-x-osiwac-4-rvm1-chkout-reflect-v1.0/	Rosetta-Orbiter OSIRIS Wide Angle Camera Rendezvous Maneuver 1 Resampled-B (Geometric Distortion Corrected in Reflectance Units) Data	RO-X-OSIWAC-4-RVM1-CHKOUT-REFLECT-V1.0
/holdings/ro-x-osiwac-4-rvm1-chkout-strlight-v1.0/	Rosetta-Orbiter OSIRIS Wide Angle Camera Rendezvous Maneuver 1 Resampled-C (Solar Stray Light and Geometric Distortion Corrected in W/m^2/sr/nm) Data	RO-X-OSIWAC-4-RVM1-CHKOUT-STRLIGHT-V1.0
/holdings/ro-x-osiwac-4-rvm1-chkout-str-refl-v1.0/	Rosetta-Orbiter OSIRIS Wide Angle Camera Rendezvous Maneuver 1 Resampled-D (Solar Stray Light and Geometric Distortion Corrected in Reflectance Units) Data	RO-X-OSIWAC-4-RVM1-CHKOUT-STR-REFL-V1.0
